R 1000  600
NO ./tex/stone.xpm
WE ./tex/wood.xpm
SO ./tex/metal.xpm
EA ./tex/skull_octocat.xpm
S ./tex/pillar.xpm
F 252,3,207
C 225,30,0

  111
1100011
1100011
 1100011   
 1100011
 1100011
   1111
